111111111111111111
1000E0000P00000001
10000E0000C0000001
100000001000000001
111111111111111111