111111111111111111111111111111
1PCCCCCCCCCCCCCCCCCCCCCCCCCCC1
1111111111111111111111110001C1
1CCC00000000CCCCC0000000CCC1C1
100000C0000C0000C000C0000001C1
1000000000000000000000000001C1
100000C0000C0001C000C0000001C1
1000000000000000000000000001C1
100000C0000C0000C0000C000001C1
1CCC000000000000000000101111C1
1CEC00000000000000000010000001
100000000000000000000000000001
111111111111111111111111111111