1111111111111111111111111111111111111
1C0C0C0C0C0C0C0C0C0C0C0C0C0C0C0C0C0C1
10C0C0C0C0C0C0C0C0C0C0C0C0C0C0C0C0C01
10000000000000000000000000000000C0001
1000000000C0C0C0C0C0C0C00000000000001
100000000C0C0C0C0C0C0C0C0000000000001
1000000000000000000000000000000000001
1P000000000000000000000000000000000E1
1111111111111111111111111111111111111